2 3 4 5 6 7 8 9 3 3 6 7 4 5 3 3 8 9 3 3 4 5 8 9 3 3 3 3 4 5 2 2
2 3 44 45 46 47 8 9 3 3 46 47 44 45 3 3 8 9 3 3 44 45 8 9 3 3 3 3 44 45 2 2
14 17 6 7 3 3 8 9 16 17 4 5 3 3 3 3 8 9 4 5 3 3 8 9 16 17 4 5 3 3 2 2
54 55 46 47 3 3 8 9 22 23 44 45 3 3 3 3 8 9 44 45 3 3 8 9 22 23 44 45 3 3 2 2
18 19 3 3 4 5 8 9 22 23 3 3 24 25 24 25 8 9 6 7 3 3 8 9 22 23 24 25 3 3 2 2
2 2 3 3 44 45 2 2 2 2 3 3 2 2 2 2 2 2 46 47 3 3 2 2 2 2 2 2 3 3 2 2
2 3 3 3 22 23 8 9 2 2 3 3 3 3 2 2 2 3 24 25 16 17 2 2 6 7 16 17 3 3 2 2
2 3 3 3 2 2 8 9 2 2 3 3 3 3 2 2 2 3 2 2 22 23 2 2 46 47 22 23 66 2 2 2
2 3 4 5 6 7 8 9 2 2 3 3 4 5 2 2 2 3 3 3 22 23 2 2 3 3 28 29 8 9 2 2
2 3 44 45 46 47 8 9 2 2 3 3 44 45 2 2 2 3 3 3 2 2 2 2 3 28 29 3 8 9 2 2
2 3 16 17 3 3 8 9 2 2 3 3 3 3 2 2 2 3 3 3 3 3 3 3 28 29 3 3 8 9 2 2
2 3 22 23 3 3 8 9 2 2 3 3 3 3 2 2 2 3 3 3 3 3 3 28 29 3 3 3 8 9 2 2