1 2 33 34 42 43 27 28 33 34 42 43 31 32 1 2 42 43 7 8 21 82 46 47 1 2 44 45 42 43 46 47 1 2 44 45 42 43 46 47 1 2 49 49 31 32 27 15
1 2 33 34 3 4 12 13 33 34 3 4 9 10 1 2 3 4 5 6 1 22 23 24 1 2 25 26 3 4 23 24 1 2 25 26 3 4 23 24 1 2 7 35 9 10 14 15
1 2 27 28 3 4 1 2 33 34 3 4 11 11 1 2 3 4 29 30 27 28 34 26 42 43 44 45 3 4 46 47 42 43 44 45 3 4 46 47 42 43 7 35 11 11 27 15
1 2 12 13 3 4 1 2 33 34 3 4 11 11 1 2 3 4 29 1 12 13 34 26 3 4 25 2 3 4 21 24 3 4 25 34 3 4 33 24 3 4 5 6 11 11 14 15
13 2 64 64 64 64 65 66 33 34 3 4 11 11 1 2 3 4 36 1 2 33 34 26 3 4 33 34 3 4 21 34 3 4 33 34 3 4 31 32 3 4 36 2 11 11 54 38
20 20 20 20 20 20 20 74 75 34 3 4 11 11 1 2 3 4 51 1 2 33 34 26 3 4 33 34 3 4 21 34 3 4 33 34 3 4 9 10 3 4 51 2 11 11 54 53
7 8 1 2 3 4 1 82 74 83 64 64 62 56 64 64 64 64 65 66 2 33 34 26 3 4 33 34 3 4 21 34 3 4 33 34 3 4 27 28 3 4 1 2 84 59 54 69
5 6 1 2 3 4 1 22 20 20 20 20 20 20 20 20 20 20 20 74 75 33 34 26 3 4 33 34 3 4 21 34 3 4 33 34 3 4 12 13 3 4 1 58 73 20 20 20
36 2 1 2 3 4 1 2 31 32 3 4 27 28 3 4 27 28 1 82 74 75 34 26 3 4 33 34 3 4 21 34 3 4 33 34 3 4 33 34 3 4 78 73 79 34 48 15
51 2 1 2 3 4 1 2 9 10 3 4 12 13 3 4 12 13 1 22 97 74 75 26 3 4 33 34 3 4 21 34 3 4 33 34 3 4 33 34 3 4 20 20 33 34 14 15
1 2 13 2 60 61 13 2 1 2 60 61 13 2 60 61 13 2 13 2 13 82 74 83 60 61 33 34 60 61 21 34 60 61 33 34 60 61 33 34 60 61 1 2 33 34 98 15
20 20 20 20 20 20 20 20 20 20 20 20 20 20 20 20 20 20 20 20 20 20 20 20 20 20 20 20 20 20 20 20 20 20 20 20 20 20 20 20 20 20 20 20 20 20 20 20