2 3 8 9 3 3 3 28 29 3 22 23 8 9 2 2 1
2 3 8 9 3 3 28 29 3 3 6 7 8 9 2 2 1
2 3 8 9 3 28 29 3 3 3 46 47 8 9 2 2 1
2 2 8 9 28 29 22 23 24 25 3 3 8 9 2 2 1
2 2 2 2 2 2 2 2 2 2 3 3 8 9 2 2 1
2 2 8 9 6 7 3 3 3 3 3 3 8 9 2 2 1
2 2 8 9 46 47 3 3 3 3 66 2 2 2 2 2 1
14 17 8 9 3 3 3 3 28 29 3 3 16 17 2 2 1
54 55 8 9 3 3 3 28 29 3 3 3 22 23 2 2 1
18 19 8 9 22 23 28 29 24 25 24 25 22 23 2 2 1
2 2 2 2 2 2 2 2 2 2 2 2 2 2 2 2 1